11111111111111111111111
10000C00000000000000001
11111111000000000000001
100000C00000000000C0001
100000000000E0000000001
10000000P00000000000001
10010000001000000010101
1000C0000000C0000000001
11111111111111111111111
